width = 5632
height = 2304

max_provinces = 8794
sea_starts = {
	1252 1254 1255 1256 1257 1258 1259 1261 1262 1263 1264 1265 1266 1267 1268 1269 1270 1271 1272 1274 1275 1276 1277 1278 1279 1280 1281 1282 1283 1284 1285 1286 
	1287 1288 1289 1290 1291 1292 1293 1294 1295 1296 1297 1298 1299 1300 1301 1302 1303 1304 1305 1307 1308 1309 1310 1311 1312 1313 1314 1315 1316 1317 1319 1320 
	1321 1322 1323 1324 1326 1328 1329 1330 1331 1332 1333 1334 1335 1336 1337 1338 1339 1340 1341 1342 1343 1344 1345 1346 1347 1348 1349 1350 1351 1352 1353 1354 
	1355 1356 1357 1358 1359 1360 1361 1362 1363 1364 1365 1366 1367 1368 1369 1370 1371 1372 1373 1374 1375 1376 1377 1378 1379 1380 1381 1382 1383 1384 1385 1386 
	1387 1388 1389 1390 1391 1392 1393 1394 1395 1396 1397 1398 1399 1400 1401 1402 1403 1404 1405 1406 1407 1408 1409 1410 1411 1412 1413 1414 1415 1416 1417 1418 
	1419 1420 1421 1422 1423 1424 1425 1426 1427 1428 1429 1430 1431 1432 1433 1434 1435 1436 1437 1438 1439 1440 1441 1442 1443 1444 1445 1446 1447 1448 1449 1450 
	1451 1452 1453 1454 1455 1456 1457 1458 1459 1460 1461 1462 1463 1464 1465 1466 1467 1468 1469 1470 1471 1472 1473 1474 1475 1476 1477 1478 1479 1480 1481 1482 
	1483 1484 1485 1486 1487 1488 1489 1490 1491 1492 1493 1494 1495 1496 1497 1498 1499 1500 1501 1502 1503 1504 1505 1506 1507 1508 1509 1510 1511 1512 1513 1514 
	1515 1516 1517 1518 1519 1520 1521 1522 1523 1524 1525 1526 1527 1528 1529 1530 1531 1532 1533 1534 1535 1536 1537 1538 1539 1540 1541 1542 1543 1544 1545 1546 
	1547 1548 1549 1550 1551 1552 1553 1554 1555 1556 1557 1558 1559 1560 1561 1562 1563 1564 1565 1566 1567 1568 1569 1570 1571 1572 1573 1574 1575 1576 1577 1578 
	1579 1580 1581 1582 1583 1584 1585 1586 1587 1588 1589 1590 1591 1592 1593 1594 1595 1596 1597 1598 1599 1600 1601 1602 1603 1604 1605 1606 1607 1608 1609 1610 
	1611 1612 1613 1614 1615 1616 1617 1618 1619 1620 1621 1622 1623 1624 1625 1626 1627 1628 1629 1630 1631 1632 1633 1634 1635 1636 1637 1638 1639 1640 1641 1642 
	1643 1644 1645 1646 1647 1652 1655 1659 1660 1661 1662 1663 1666 1667 1668 1669 1670 1671 1672 1673 1674 1675 1676 1677 1678 1679 1680 1681 1682 1683 1684 1685 
	1686 1687 1688 1689 1690 1691 1692 1693 1694 1695 1696 1697 1698 1699 1700 1701 1702 1703 1704 1705 1706 1707 1708 1709 1710 1711 1712 1713 1714 1715 1716 1717 
	1718 1719 1720 1721 1722 1723 1724 1725 1726 1727 1728 1729 1730 1731 1732 1733 1734 1735 1736 1737 1738 1739 1740 1741 1888 1895 1896 1897 1898 1910 1911 1917 
	1919 1920 2471 1924 1926 1927 1928 1929 1932 1975 1977 1980 3303 3004 3007 3010 3011 3012 3013 3016 3017 3018 3020 3021 3347 3584 3585 3586 3587 3936 4224 4225 
	4226 4233 4234 4235 4333 4346 4357 4358 5107 5200 5201 5207 5208 5209 5227 5452 5453 5454 5455 5456 5457 5458 5459 5460 5461 5462 5463 5464 5465 5466 5467 5468 
	5470 5472 5473 5474 5475 5476 5479 5480 5481 5482 5483 5484 5485 5486 5493 5494 5495 5499 5547 5549 5926 5927 5928 5929 5930 5931 5932 5933 5934 5961 5962 5963 
	5964 5965 5966 5967 5968 5941 5942 5943 5944 5945 5946 5947 5948 5949 5950 5983 5985 6018 6021 6022 6023 6024 6025 6026 6027 6028 6029 6030 6031 6032 6033 6034 
	6035 6036 6037 6038 6041 6060 6062 6063 6064 6065 6066 6067 6068 6070 6071 6073 6074 6075 6076 6077 6078 6079 6081 6082 6083 6084 6085 6086 6087 6088 6108 6148 
	6149 6150 6151 6152 6153 6154 6155 6156 6157 6158 6159 6160 6161 6162 6163 6164 6165 6166 6167 6168 6169 6170 6171 6220 6225 6227 6228 6231 6232 6235 6236 6237 
	6238 6239 6353 6354 6355 6356 6357 6358 6359 6360 6361 6362 6363 6578 6583 6584 6592 6593 6594 6595 6596 6597 6598 6599 6600 6646 6647 6673 6679 6080 6698 6699 
	6700 6701 6702 6703 6704 6705 6706 6707 6708 6709 6710 6711 6712 6713 6714 6715 6716 6717 6718 6719 6720 6721 6722 6723 6724 6725 6726 6727 6728 6729 6730 6731 
	6925 6926 6986 6987 6988 6989 6990 6991 6992 6993 6994 6995 6996 6997 7280 7281 7282 7283 7284 7285 7286 7287 7288 7289 7290 7291 7292 7293 7294 7295 7297 7298 
	7299 7300 7301 7302 7303 7304 7305 7306 7307 7308 7309 7310 7311 7312 7313 7321 7322 7323 7324 7325 7326 7327 7328 7329 7330 7331 7332 7333 7334 7335 7336 7337 
	7338 7339 7340 7341 7342 7343 7344 7345 7346 7347 7348 7349 7350 7351 7352 7354 7355 7356 7377 7385 7386 7387 7388 7389 7390 7391 7392 7393 7394 7395 7396 7397 
	7398 7399 7400 7401 7402 7403 7404 7405 7406 7407 7408 7409 7410 7411 7412 7413 7414 7415 7885 7886 7887 7888 8302 8311 8312 8313 8314 8315 8316 8317 8318 8319 
	8326 8327 8328 8329 8330 8331 8332 8333 8334 8335 8336 8337 8338 8339 8340 8342 8343 8344 8345 8346 8347 8348 8349 8350 8351 8352 8353 8354 8355 8356 8357 8358 
	8359 8360 8361 8362 8363 8364 8365 8366 8367 8368 8369 8370 8371 8372 8373 8374 8375 8376 8379 8380 8381 8382 8383 8384 8385 8386 8387 8388 8389 8390 8391 8392 
	8393 8394
}

only_used_for_random = {
    #Error Log readings and safe to use for new provinces
    3351 3352 3353 3354 3355 3356 3357 3358 3359 3360 3361 3362 3363 3364 3365 3366 3367 3368 3369 3370 3371 3372 3373 3374 3375 3376 3377 3378 3379 
	3380 3381 3382 3383 3384 3385 3386 3387 3388 3389 3390 3391 3392 3393 3394 3395 3396 3397 3398 3399 3400 3401 3402 3403 3404 3405 3406 3407 3408 3409 3410 3411 
	3412 3413 3414 3415 3416 3417 3418 3419 3420 3421 3422 3423 3424 3425 3426 3427 3428 3429 3430 3431 3432 3433 3434 3435 3436 3437 3438 3439 3440 3441 3442 3443 
	3444 3445 3446 3447 3448 3449 3450 3451 3452 3453 3454 3455 3456 3457 3458 3459 3460 3461 3462 3463 3464 3465 3466 3467 3468 3469 3470 3471 3472 3473 3474 3475 
	3476 3477 3478 3479 3480 3481 3482 3483 3484 3485 3486 3487 3488 3489 3490 3491 3492 3493 3494 3495 3496 3497 3498 3499 3500 3501 3502 3503 3504 3505 3506 3507 
	3508 3509 3510 3511 3512 3513 3514 3515 3516 3517 3518 3519 3520 3521 3522 3523 3524 3525 3526 3527 3528 3529 3530 3531 3532 3533 3534 3535 3536 3537 3538 3539 
	3540 3541 3542 3543 3544 3545 3546 3547 3548 3549 3550 3551 3552 3553 3554 3555 3556 3557 3558 3559 3560 3561 3562 3563 3564 3565 3566 3567 3568 3569 3570 3571 
	3572 3573 3574 3575 3576 3577 3578 3579 3580 3581 3582 3583
}

lakes = {
	1250 1251 1253 1260 1325 1327 1648 1649 1650 1651 1653 1654 1656 1657 1658 1664 1665 1883 1884 1885 1886 1887 1889 1890 1891 1892 1893 1894 1899 1900 1902 1903 
	1904 1905 1906 1907 1908 1909 1912 1914 1915 1916 1918 1921 1922 1923 1976 2000 2001 2953 3015 3287 3288 3289 4000 4001 4002 4003 4004 4005 4006 4007 4008 4009 
	4010 4011 4012 4013 4014 4015 4016 4017 4018 4019 4132 4133 4134 4135 4136 4137 4138 4139 4870 4940 4941 5100 5101 5102 5103 5104 5105 5106 5108 5109 5110 5429 
	5471 5477 5487 5488 5489 5490 5491 5492 5496 5497 5498 5500 5501 5502 5503 5469 5478 5504 5505 5522 6042 6043 6044 6045 6046 6047 6048 6049 6050 6051 6052 6053 
	6054 6055 6056 6057 6058 6059 6061 6069 6172 6173 6216 6217 6218 6219 6221 6222 6223 6224 6226 6229 6230 6233 6234 6240 6241 6242 6243 6244 6245 6246 6247 6248 
	6249 6250 6251 6252 6253 6254 6255 6256 6257 6258 6259 6260 6261 6262 6263 6264 6265 6266 6267 6268 6269 6270 6271 6272 6273 6274 6275 6276 6277 6278 6279 6280 
	6281 6282 6283 6284 6285 6286 6287 6288 6289 6290 6291 6292 6293 6294 6295 6296 6297 6298 6299 6300 6301 6302 6303 6304 6305 6306 6307 6308 6309 6310 6311 6312 
	6313 6314 6315 6316 6317 6318 6319 6320 6321 6322 6323 6324 6325 6326 6327 6328 6329 6330 6331 6332 6333 6334 6335 6336 6337 6338 6339 6340 6341 6342 6343 6344 
	6345 6346 6347 6348 6349 6350 6351 6352 6364 6365 6366 6367 6368 6369 6370 6372 6373 6374 6375 6376 6377 6378 6379 6380 6381 6382 6383 6384 6385 6386 6387 6388 
	6389 6390 6391 6392 6393 6394 6395 6396 6397 6398 6399 6400 6401 6402 6403 6404 6405 6406 6407 6408 6409 6410 6411 6412 6413 6414 6415 6416 6417 6418 6419 6420 
	6421 6422 6423 6432 6433 6577 6677 6678 6685 6686 6687 6688 6689 6690 6691 6692 6693 6694 6695 6696 6697 6956 6970 7186 7187 7296 7353 7883 7884 8300 8301 8303 
	8304 8305 8306 8307 8308 8309 8310 8320 8321 8322 8323 8324 8325 8341 8377 8378 8395
}

force_coastal = {
}

definitions = "definition.csv"
provinces = "provinces.bmp"
positions = "positions.txt"
terrain = "terrain.bmp"
rivers = "rivers.bmp"
terrain_definition = "terrain.txt"
heightmap = "heightmap.bmp"
tree_definition = "trees.bmp"
continent = "continent.txt"
adjacencies = "adjacencies.csv"
climate = "climate.txt"
region = "region.txt"
superregion = "superregion.txt"
area = "area.txt"
provincegroup = "provincegroup.txt"
ambient_object = "ambient_object.txt"
seasons = "seasons.txt"
trade_winds = "trade_winds.txt"
canal_definition = {
	name = "panama_canal"
	x = 1317
	y = 1082
}
canal_definition = {
	name = "suez_canal"
	x = 3111
	y = 1454
}
canal_definition = {
	name = "second_suez_canal"
	x = 3111
	y = 1454
}
canal_definition = {
	name = "kiel_canal"
	x = 2748
	y = 1904
}
canal_definition = {
	name = "don_and_volga_canal"
	x = 3295
	y = 1787
}
canal_definition = {
	name = "ludwig_canal"
	x = 2752
	y = 1788
}

canal_definition = {
	name = "kra_canal"
	x = 4151
	y = 1128
}

canal_definition = {
	name = "welland_canal"
	x = 1365
	y = 1681
}

canal_definition = {
	name = "djerid_canal"
	x = 2768
	y = 1530
}

# Define which indices in trees.bmp palette which should count as trees for automatic terrain assignment
tree = { 3 4 7 10 }
